
NO   ./textures/n_tex.xpm
SO  ./textures/s_tex.xpm

F 34,139,34
WE   ./textures/w_tex.xpm
EA   ./textures/e_tex.xpm

C   20,20,235

111111111111
100000000001
100010000001
100000000001
100001000001
100000000001
100000001001
1000E0001001
100000000001
111111111111
