
NO   ./textures/n_tex.xpm
SO  ./textures/s_tex.xpm

F 22,0,0
WE   ./textures/w_tex.xpm
EA   ./textures/e_tex.xpm

C   22,22,255

111111111111
100000000001
100010000001
100000000001
100001000001
100000000001
100000001001
100N00001001
100000000001
111111111111
